S~~~~~~~~~~~~~~~~~~~~~~~~~~~~
~b~b~b~b~b~b~b~b~b~b~b~b~b~b~
~~~~~~~~~~~~~~~~~~~~~~~~~~~~~
~b~b~b~b~b~b~b~b~b~b~b~b~b~b~
~~~~~~~~~~~~~~~~~~~~~~~~~~~~~
~b~b~b~b~b~b~b~b~b~b~b~b~b~b~
~~~~~~~~~~~~~~~~~~~~~~~~~~~~~
~b~b~b~b~b~b~b~b~b~b~b~b~b~b~
~~~~~~~~~~~~~~~~~~~~~~~~~~~~~
~b~b~b~b~b~b~b~b~b~b~b~b~b~b~
~~~~~~~~~~~~~~~~~~~~~~~~~~~~~
~b~b~b~b~b~b~b~b~b~b~b~b~b~b~
~~~~~~~~~~~~~~~~~~~~~~~~~~~~~
~b~b~b~b~b~b~b~b~b~b~b~b~b~b~
~~~~~~~~~~~~~~~~~~~~~~~~~~~~~
~b~b~b~b~b~b~b~b~b~b~b~b~b~b~
~~~~~~~~~~~~~~~~~~~~~~~~~~~~~
~b~b~b~b~b~b~b~b~b~b~b~b~b~b~
~~~~~~~~~~~~~~~~~~~~~~~~~~~~~
~b~b~b~b~b~b~b~b~b~b~b~b~b~b~
~~~~~~~~~~~~~~~~~~~~~~~~~~~~G
